1111111
1P000C1
1111011
1C00001
1000111
10E0001
1111111
