11111
1P0C1
10001
1C001
11111
