111111111111111
100000000000001
101110111011101
10P00000C000001
101110111011101
1000C0000C00001
101110111011101
10000000C000E01
101110111011101
111111111111111
