111111111111111
1P0000000000001
101111111111101
100000000000001
1C01111111110E1
100000000000001
1M00000000000M1
111111111111111