111111111
1P0000001
111111101
1C00000E1
111111111