111111111111111
1P000C00000C001
101110M11110101
100000000000001
1C111M1M1111C01
100000000000001
101110M11110101
1000C00000C00E1
111111111111111
