11111111111111111
1000000C00M000001
1011111111111C101
10P00M00000000101
101111C1111111101
100000010M0000001
1C1111010111M1101
100M00000100000E1
11111111111111111
