1111111111111
10010000000C1
1000011111001
1P0011M000001
1111111111111
10C0000C00001
10000M0000E01
1111111111111
