11111
100C1
10001
1C0E1
11111
