11111
1P0C1
1001
1C0E11
11111
