111111
1P0001
111C11
1C0E11
111111
