1111111111111111111111111
1000000000000000000000001
1011111101111110111111101
10C000010000001000000C101
1011111101111110111111101
100000000000000000000P001
1011111101111110111111101
10C00001000E001000000C101
1011111101111110111111101
1000000000000000000000001
1011111101111110111111101
10C000010000001000000C101
1011111101111110111111101
1000000000000000000000001
1111111111111111111111111
