111111111111111111111111111111
100000000000000000000000000001
101111110111111101111111011101
1000C0010000000100000C10000C01
101111110111111101111111011101
100000000000000000000000000001
101111110111111101111111011101
10000001000C00010000000100P001
101111110111111101111111011101
100000000000000000000000000001
101111110111111101111111011101
10C00001000000010000C00100E001
101111110111111101111111011101
100000000000000000000000000001
101111110111111101111111011101
1000C0010000C00100000001000001
101111110111111101111111011101
100000000000000000000000000001
101111110111111101111111011101
111111111111111111111111111111
