111111
1P0001
100C01
1C0E11
111111
