1111111111111111111111
1P00000C00000000000001
10111111111M1111111101
100M000000000000C00001
101111M11111111111C101
10C0000M0000M000000101
1011111111111111111101
100000C00M00000M000001
101111111011111C111101
10M000000000000000M001
1011111M111111M1111101
100C00000000000000C0E1
1111111111111111111111
