11111111
1P0000E1
1M011001
1000C0M1
11111111
