1111111111111
1P0000E100001
1M00100000001
1000C000000M1
1000C000000M1
10000000000M1
1000C000000M1
1111111111111
