111111111111111
1P00000000CM001
101111111111101
1000000M00C0001
1C00111111110E1
1000CM000000001
1M00000000000M1
111111111111111
