1111111
1P000E1
100M001
1C00001
1111111
